AGU: ZAC JAL 
BCN: BCS SON
BCS: BCN
CAM: ROO YUC TAB
CHP: TAB OAX VER
CHH: COA SON SIN DUR 
COA: NLE CHH DUR ZAC 
COL: JAL MIC
DIF: MEX MOR
DUR: SIN NAY JAL ZAC CHH COA
GUA: SLP JAL QUE MIC
GRO: MIC MEX MOR PUE OAX
HID: QUE MEX VER SLP TLA PUE
JAL: NAY ZAC GUA COL MIC AGU DUR
MEX: HID QUE MIC GRO MOR DIF PUE QUE
MIC: JAL COL GUA GRO MEX QUE
MOR: PUE GRO MEX DIF
NAY: JAL SIN DUR 
NLE: COA TAM SLP
OAX: GRO VER CHP PUE
PUE: VER OAX GRO MOR TLA MEX HID
QUE: GUA HID SLP MIC MEX
ROO: YUC CAM
SLP: GUA ZAC NLE TAM HID VER QUE
SIN: SON CHH DUR NAY
SON: CHH BCN SIN
TAB: CHP CAM VER
TAM: NLE SLP VER
TLA: PUE HID
VER: TAM SLP PUE HID TAB OAX CHP
YUC: ROO CAM
ZAC: DUR COA SLP AGU JAL 
